############
#         B#
# ######## #
# #        #
# ####### ##
# #        #
# ######## #
#        # #
# ######  #
# #       #
# # #######
A         
